############################
#............##............#
#.####.#####.##.#####.####.#
#..........................#
#.####.#.##########.#.####.#
#......#.....##.....#......#
######.##### ## #####.######
     #.#            #.#
	 #.#  ###==###  #.#
######.#  #      #  #.######
	  .   #      #   .
######.#  #      #  #.######
	 #.#  ########  #.#
	 #.#            #.#
######.# ########## #.######
#............##............#
#.####.#####.##.#####.####.#
#+..##.......  .......##..+#
###.##.##.########.##.##.###
#......##....##....##......#
#.##########.##.##########.#
#..........................#
############################
