###########################
#............#............#
#.####.#####.#.#####.####.#
#.........................#
#.####.#.#########.#.####.#
#......#.....#.....#......#
######.##### # #####.######
     #.#           #.#
     #.#  ###=###  #.#
######.#  #     #  #.######
      .   #     #   .
######.#  #     #  #.######
     #.#  #######  #.#
     #.#           #.#
######.# ######### #.######
#............#............#
#.####.#####.#.#####.####.#
#+..##....... .......##..+#
###.##.##.#######.##.##.###
#......##....#....##......#
#.##########.#.##########.#
#.........................#
###########################
EOF