###########################
#............#............#
#.####.#####.#.#####.####.#
#.........................#
#+####.#.#########.#.####+#
#......#.....#.....#......#
######.##### # #####.######
     #.#     B     #.#
     #.# ####=#### #.#
######.# #---^---# #.######
<     .  #-GG^GG-#  .     >
######.# #---^---# #.######
     #.# ######### #.#
     #.#     P     #.#
######.# ######### #.######
#............#............#
#.####.#####.#.#####.####.#
#+..##....... .......##..+#
###.##.##.#######.##.##.###
#......##....#....##......#
#.##########.#.##########.#
#.........................#
###########################